#coinmarketcap map
#Sat Dec 08 12:12:55 MSK 2018
bitgold=BITGOLD
tracto=TRCT
gridcoin=GRC
vestoria=VSTR
goldmint=MNTP
flash=FLASH
digix-gold-token=DGX
crycash=CRC
pluracoin=PLURA
ethorse=HORSE
viacoin=VIA
piplcoin=PIPL
rivetz=RVT
ultra-salescoud=UST
haracoin=HRC
asch=XAS
turtlecoin=TRTL
bitdegree=BDG
fuzex=FXT
loopring=LRC
syscoin=SYS
ravencoin=RVN
dxchain-token=DX
iquant=IQT
proton-token=PTT
intelligent-investment-chain=IIC
monacocoin=XMCC
aion=AION
goodomy=GOOD
playgroundz=IOG
aichain=AIT
bitcoin-zero=BZX
bezop=BEZ
hashgard=GARD
evencoin=EVN
adenz=DNZ
patron=PAT
gamblecoin=GMCN
smartcash=SMART
experience-token=EXT
cashbet-coin=CBC
monero-original=XMO
aricoin=ARI
megacoin=MEC
truechain=TRUE
canyacoin=CAN
chex=CHEX
briacoin=BRIA
iconomi=ICN
provoco-token=VOCO
wild-beast-block=WBB
ethergem=EGEM
yenten=YTN
yocoin=YOC
shift=SHIFT
vslice=VSL
own=CHX
huobi-token=HT
pyrexcoin=PYX
poly-ai=AI
elastos=ELA
bettex-coin=BTXC
peercoin=PPC
deeponion=ONION
absolute=ABS
rhenium=XRH
starchain=STC
spacechain=SPC
cpollo=CPLO
vexanium=VEX
shadow-token=SHDW
royal-kingdom-coin=RKC
bitcoin-one=BTCONE
ethereum-lite=ELITE
spectre-utility=SXUT
elliot-coin=ELLI
dragonglass=DGS
cryptrust=CTRT
emercoin=EMC
denarius-dnr=D
gobyte=GBX
robet=ROBET
nuggets=NUG
snowgem=XSG
thingschain=TIC
snipcoin=SNIP
credit-tag-chain=CTC
steem-dollars=SBD
cryptoflow=CFL
litedoge=LDOGE
commodity-ad-network=CDX
idealcash=DEAL
incodium=INCO
monetha=MTH
ripio-credit-network=RCN
iconiq-lab-token=ICNQ
nam-coin=NAM
fairgame=FAIR
veros=VRS
bitcoin-sv=BSV
alqo=XLQ
sureremit=RMT
growers-international=GRWI
everex=EVX
stex=STEX
adcoin=ACC
new-power-coin=NPW
grandcoin=GDC
educare=EKT
qbic=QBIC
grid=GRID
elysium=ELS
alphabitcoinfund=ABC
ethersocial=ESN
bitsilver=BITSILVER
internationalcryptox=INCX
publica=PBL
change=CAG
blockmason=BCPT
pandemia=PNDM
procurrency=PROC
airwire=WIRE
rise=RISE
iht-real-estate-protocol=IHT
dietbitcoin=DDX
noku=NOKU
nexo=NEXO
covesting=COV
carvertical=CV
delta-chain=DELTA
wintoken=WIN
carinet=CIT
blocktix=TIX
bitqy=BQ
ost=OST
digiwage=WAGE
bitbtc=BITBTC
altcoin-alt=ALT
anoncoin=ANC
buzzcoin=BUZZ
jesus-coin=JC
pioneer-coin=PCOIN
bitdice=CSNO
matrix-ai-network=MAN
qubitcoin=Q2C
gravity=GZRO
skrumble-network=SKM
auctus=AUC
b3coin=KB3
hondaiscoin=HNDC
ttc-protocol=TTC
no-bs-crypto=NOBS
thekey=TKY
hellogold=HGT
nasdacoin=NSD
nolimitcoin=NLC2
knoxstertoken=FKX
freyrchain=FREC
ice-rock-mining=ROCK2
medibloc=MED
paymon=PMNT
metal=MTL
idol-coin=IDOL
cottoncoin=COTN
president-trump=PRES
4new=KWATT
firstcoin=FRST
bubble=BUB
icobid=ICOB
yee=YEE
lamden=TAU
arcblock=ABT
labh-coin=LABH
musicoin=MUSIC
noir=NOR
worldcore=WRC
zayedcoin=ZYD
distributed-credit-chain=DCC
goldblocks=GB
wabnetwork=WAB
argentum=ARG
adbank=ADB
avinoc=AVINOC
oraclechain=OCT
amo-coin=AMO
etheera=ETA
trackr=TKR
apollon=XAP
apr-coin=APR
hypercash=HC
buggyra-coin-zero=BCZERO
ammo-reloaded=AMMO
pabyosi-coin-special=PCS
sola-token=SOL
you-coin=YOU
coinpoker=CHP
paragon=PRG
etherdelta-token=EDT
ellaism=ELLA
blakestar=ERA
atonomi=ATMI
sether=SETH
ea-coin=EAG
formosa-financial=FMF
paccoin=$PAC
global-awards-token=GAT
bigup=BIGUP
kekcoin=KEK
pedity=PEDI
halloween-coin=HALLO
ethereum-blue=BLUE
benjirolls=BENJI
eccoin=ECC
faceter=FACE
curecoin=CURE
cryptocarbon=CCRB
c-bit=XCT
infinipay=IFP
sakuracoin=SKR
cyberfm=CYFM
sharex=SEXC
loyalcoin=LYL
ccore=CCO
hydrogen=HYDRO
record=RCD
casinocoin=CSC
minex=MINEX
auroracoin=AUR
sprouts=SPRTS
sirin-labs-token=SRN
ongsocial=ONG
nusd=NUSD
sagacoin=SAGA
trueusd=TUSD
monero-classic=XMC
vechain=VET
bitmark=BTM
biteur=BITEUR
plancoin=PLAN
valuto=VLU
genesisx=XGS
iqeon=IQN
arcticcoin=ARC
transfercoin=TX
pecunio=PCO
carboncoin=CARBON
rentberry=BERRY
ink-protocol=XNK
education-ecosystem=LEDU
rabbitcoin=RBBT
sharpay=S
essentia=ESS
live-stars=LIVE
fargocoin=FRGC
quebecoin=QBC
mmocoin=MMO
alt-estate-token=ALT
ong=ONG
micromines=MICRO
celsius=CEL
anarchistsprime=ACP
lightpaycoin=LPC
earth-token=EARTH
bezant=BZNT
pylon-network=PYLNT
valuecybertoken=VCT
zeepin=ZPT
newstoken=NEWOS
constellation=DAG
salpay=SAL
sentinel=SENT
marijuanacoin=MAR
eltcoin=ELTCOIN
robotina=ROX
swisscoin=SIC
latiumx=LATX
numus=NMS
herocoin=PLAY
dreamcoin=DRM
bitusd=BITUSD
bank-coin=BANK
swarm-city=SWT
dero=DERO
qbao=QBT
bitstar=BITS
cazcoin=CAZ
alis=ALIS
neoscoin=NEOS
olympus-labs=MOT
primas=PST
energitoken=ETK
eztoken=EZT
menlo-one=ONE
marscoin=MARS
verge=XVG
belacoin=BELA
foldingcoin=FLDC
latoken=LA
wiki-token=WIKI
bottos=BTO
digibyte=DGB
abcc-token=AT
equal=EQL
tierion=TNT
quarkchain=QKC
pareto-network=PARETO
radium=RADS
eosblack=BLACK
simmitri=SIM
on-live=ONL
senderon=SDRN
digital-money-bits=DMB
edu-coin=EDU
decent=DCT
monacoin=MONA
helbiz=HBZ
bulwark=BWK
peculium=PCL
stacs=STACS
graviocoin=GIO
shivom=OMX
bastonet=BSN
fintab=FNTB
dentacoin=DCN
opal=OPAL
orbitcoin=ORB
dock=DOCK
alchemint-standards=SDS
wizbl=WBL
ondori=RSTR
deviantcoin=DEV
trustnote=TTT
ternio=TERN
genesis-vision=GVT
trezarcoin=TZC
playcoin=PLY
optimal-shelf-availability-token=OSA
fcoin-token=FT
cononchain=CZR
adshares=ADST
aurora=AOA
startercoin=STAC
aditus=ADI
auxilium=AUX
dimcoin=DIM
sixeleven=611
tittiecoin=TTC
theta-token=THETA
crystal-clear=CCT
ethereum-dark=ETHD
switcheo=SWTH
target-coin=TGT
californium=CF
dent=DENT
posex=PEX
engine=EGCC
revolutionvr=RVR
matryx=MTX
obsidian=ODN
origami=ORI
dao-casino=BET
42-coin=42
blockv=VEE
xchange=XCG
worldcoin=WDC
ailink-token=ALI
empowr-coin=EMPR
trollcoin=TROLL
revolvercoin=XRE
globaltoken=GLT
coin-lion=LION
spectrecoin=XSPEC
nuls=NULS
tekcoin=TEK
purevidz=VIDZ
decred=DCR
x-coin=XCO
italian-lira=ITL
altcommunity-coin=SONO
moving-cloud-coin=MCC
qube=QUBE
piggycoin=PIGGY
dascoin=DASC
whitecoin=XWC
goldcoin=GLD
bolenum=BLN
global-currency-reserve=GCR
oneledger=OLT
deepbrain-chain=DBC
datum=DAT
magi=XMG
bitcoin-red=BTCRED
rocketcoin=ROCK
promotion-coin=PC
regalcoin=REC
molecule=MOL
refereum=RFR
canada-ecoin=CDN
btctalkcoin=TALK
encrypgen=DNA
hyperquant=HQT
hackspace-capital=HAC
realtract=RET
galactrum=ORE
truedeck=TDP
tv-two=TTV
geysercoin=GSR
putincoin=PUT
renos=RNS
arbit=ARB
circuits-of-value=COVAL
cvcoin=CVN
truckcoin=TRK
swftcoin=SWFTC
insurchain=INSUR
bitswift=BITS
consentium=CSM
moeda-loyalty-points=MDA
graft=GRFT
gladius-token=GLA
zeitcoin=ZEIT
etheriya=RIYA
coimatic-3=CTIC3
coimatic-2=CTIC2
paypie=PPP
phore=PHR
plexcoin=PLX
rlc=RLC
wispr=WSP
eristica=ERT
sovereign-hero=HERO
abulaba=AAA
cybermusic=CYMT
utrum=OOT
ontology=ONT
encryptotel-eth=ETT
oceanchain=OC
hoqu=HQX
popchain=PCH
propy=PRO
billionaire-token=XBL
commercium=CMM
business-credit-alliance-chain=BCAC
wys-token=WYS
insanecoin-insn=INSN
datacoin=DTC
toacoin=TOA
nerves=NER
alax=ALX
lendingblock=LND
nevacoin=NEVA
neutron=NTRN
hurify=HUR
bit-tube=TUBE
zurcoin=ZUR
sentinel-protocol=UPP
streamr-datacoin=DATA
first-bitcoin-capital=BITCF
blockport=BPT
crypto-harbor-exchange=CHE
parkingo=GOT
brokernekonetwork=BNN
cortex=CTXC
popularcoin=POP
ponzicoin=PONZI
authorship=ATS
lunyr=LUN
dubaicoin-dbix=DBIX
bigbom=BBO
ethlend=LEND
coinlancer=CL
wagerr=WGR
smileycoin=SMLY
vivo=VIVO
opcoinx=OPCX
atlantis-blue-digital-token=ABDT
niobium-coin=NBC
ormeus-coin=ORME
clams=CLAM
omencoin=OMEN
decision-token=HST
minereum=MNE
wabi=WABI
ixcoin=IXC
origin-sport=ORS
atidium=ATD
eos=EOS
commerce-data-connection=CDC
paypex=PAYX
unibright=UBT
insights-network=INSTAR
hollywoodcoin=HWC
everipedia=IQ
adx-net=ADX
huzu=HUZU
scorum-coins=SCR
joint-ventures=JOINT
yuan-chain-coin=YCC
aeron=ARN
rubies=RBIES
atbcoin=ATB
monkey-project=MONK
independent-money-system=IMS
heat-ledger=HEAT
kucoin-shares=KCS
netkoin=NTK
uttoken=UTT
darsek=KED
mobilego=MGO
rate3=RTE
tokencard=TKN
digifinextoken=DFT
hodlcoin=HODL
edgeless=EDG
oax=OAX
invacio=INV
ubiq=UBQ
credits=CS
vite=VITE
raiden-network-token=RDN
sentinel-chain=SENC
kind-ads-token=KIND
pandacoin-pnd=PND
bitbay=BAY
blockpool=BPL
lomocoin=LMC
oyster=PRL
bitbar=BTB
netko=NETKO
neverdie=NDC
dix-asset=DIX
social-lending-token=SLT
xceltoken=XCEL
uquid-coin=UQC
fidelium=FID
reddcoin=RDD
zelcash=ZEL
elysian=ELY
sugar-exchange=SGR
w3coin=W3C
joulecoin=XJO
intelligent-trading-foundation=ITT
deex=DEEX
indinode=XIND
holo=HOT
uchain=UCN
ip-exchange=IPSX
rublix=RBLX
stockchain=SCC
paycent=PYN
sparks=SPK
bitcoin-gold=BTG
olympic=OLMP
revain=R
hold=HOLD
bitcoin-scrypt=BTCS
burst=BURST
bitf=BITF
coinvest=COIN
luxcoin=LUX
thrive-token=THRT
dragon-coins=DRG
aeon=AEON
dinastycoin=DCY
hexx=HXX
lisk=LSK
qash=QASH
cindicator=CND
snodecoin=SND
fusion=FSN
gazecoin=GZE
ubcoin-market=UBC
masari=MSR
kingn-coin=KNC
safeinsure=SINS
zilla=ZLA
axpire=AXPR
neurochain=NCC
evergreencoin=EGC
mib-coin=MIB
red=RED
particl=PART
bluecoin=BLU
nav-coin=NAV
pascal-coin=PASC
blocktrade-token=BTT
atomic-coin=ATOM
crypticcoin=CRYP
jingtum-tech=SWTC
invictus-hyperion-fund=IHF
purex=PUREX
tokendesk=TDS
myriad=XMY
novacoin=NVC
britcoin=BRIT
ryo-currency=RYO
lampix=PIX
rocket-pool=RPL
starta=STA
icon=ICX
xpa=XPA
ubex=UBEX
hi-mutual-society=HMC
basic-attention-token=BAT
darcio-ecosystem-coin=DEC
super-bitcoin=SBTC
biblepay=BBP
project-coin=PRJ
socialcoin-socc=SOCC
storiqa=STQ
heartbout=HB
appcoins=APPC
cryptaur=CPT
atmos=ATMOS
bloomtoken=BLT
bitcoinz=BTCZ
sumokoin=SUMO
medibit=MEDIBIT
bitcoinx=BCX
apollo-currency=APL
high-voltage=HVCO
privcy=PRIV
divi-exchange-token=DIVX
aelf=ELF
aphelion=APH
qtum=QTUM
phoenixcoin=PXC
kun=KUN
qurito=QURO
darextravel=DART
otcbtc-token=OTB
adhive=ADH
compucoin=CPN
synergy=SNRG
newton-coin-project=NCP
guppy=GUP
i0coin=I0C
lynx=LYNX
bitnation=XPAT
808coin=808
ico-openledger=ICOO
pitiscoin=PTS
uniform-fiscal-object=UFO
pakcoin=PAK
unlimitedip=UIP
phonecoin=PHON
stipend=SPD
linx=LINX
etherinc=ETI
newyorkcoin=NYC
gochain=GO
cargox=CXO
speed-mining-service=SMS
hush=HUSH
cruisebit=CRBT
doubloon=BOAT
gonetwork=GOT
beetle-coin=BEET
atheios=ATH
sonder=SNR
blazercoin=BLAZR
lina=LINA
deuscoin=DEUS
merculet=MVP
talao=TALAO
polis=POLIS
graphcoin=GRPH
proximax=XPX
numeraire=NMR
petrodollar=XPD
project-x=NANOX
synereo=AMP
0xbtc=0xBTC
seele=SEELE
electra=ECA
zetacoin=ZET
shping=SHPING
bgogo-token=BGG
medishares=MDS
kora-network-token=KNT
bitcoin-token=BTK
iconic=ICON
nxt=NXT
hero=HERO
mooncoin=MOON
daps-token=DAPS
digitalcoin=DGC
boscoin=BOS
omnitude=ECOM
brahmaos=BRM
luna-stars=LSTR
game=GTC
mercury=MER
masternodecoin=MTNC
rookiecoin=RKC
peony=PNY
emaratcoin=AEC
cryptopiafeeshares=CEFS
cryptonite=XCN
xinfin-network=XDCE
viuly=VIU
coinex-token=CET
quotient=XQN
bitdeal=BDL
viberate=VIB
javascript-token=JS
huntercoin=HUC
vulcano=VULC
repo=REPO
swarm-fund=SWM
russian-mining-coin=RMC
taas=TAAS
milocoin=MILO
monetaryunit=MUE
mktcoin=MLM
fundrequest=FND
lanacoin=LANA
experience-points=XP
rock=RKT
morpheus-network=MRPH
gsenetwork=GSE
qwark=QWARK
runners=RUNNERS
couchain=COU
lala-world=LALA
profile-utility-token=PUT
cpchain=CPC
dimecoin=DIME
polymath-network=POLY
animecoin=ANI
fivebalance=FBN
mytoken=MT
proud-money=PROUD
sharechain=SSS
solarcoin=SLR
blitzpredict=XBP
gamechain=GCS
mainframe=MFT
selfkey=KEY
arbidex=ABX
chainlink=LINK
thunderstake=TSC
leviar=XLC
safe-exchange-coin=SAFEX
sphere=SPHR
igtoken=IG
pchain=PAI
einsteinium=EMC2
ixledger=IXT
datx=DATX
rimbit=RBT
high-performance-blockchain=HPB
html-coin=HTML
intercrone=ICR
ignis=IGNIS
clearpoll=POLL
restart-energy-mwat=MWAT
aquariuscoin=ARCO
cashbery-coin=CBC
comsa-eth=CMS
carboneum-c8-token=C8
boutspro=BOUTS
betterbetting=BETR
iot-chain=ITC
allcoin=ALC
data=DTA
content-neutrality-network=CNN
concierge-coin=CCC
blox=CDT
parkgene=GENE
indorse-token=IND
byteball=GBYTE
connectjob=CJT
unify=UNIFY
srcoin=SRCOIN
bitcoin-cash=BCH
rotharium=RTH
sportyco=SPF
mfit-coin=MFIT
dash=DASH
cashcoin=CASH
paycoin2=XPY
deutsche-emark=DEM
pressone=PRS
evil-coin=EVIL
hydro-protocol=HOT
content-and-ad-network=CAN
medical-chain=MTN
mobilinktoken=MOLK
nitro=NOX
kobocoin=KOBO
zealium=NZL
bdt-token=BDT
clipper-coin=CCCX
the-abyss=ABYSS
modultrade=MTRC
chronobank=TIME
zmine=ZMN
jibrel-network=JNT
trumpcoin=TRUMP
bullion=CBX
printex=PRTX
bankex=BKX
mindexcoin=MIC
cubits=QBT
audiocoin=ADC
timicoin=TMC
humaniq=HMQ
cobinhood=COB
dogecoin=DOGE
dether=DTH
nectar=NEC
securecoin=SRC
arepacoin=AREPA
monero=XMR
hitchain=HIT
cybereits=CRE
bitstation=BSTN
xel=XEL
ab-chain-rtb=RTB
shipchain=SHIP
bitcoinote=BTCN
bitrent=RNTB
binance-coin=BNB
bingocoin=BOC
valuechain=VLC
platincoin=PLC
bitrewards=BIT
quatloo=QTL
droxne=DRXNE
simdaq=SMQ
okcash=OK
universal-currency=UNIT
life=LIFE
student-coin=STU
emerald=EMD
vetri=VLD
prime-xi=PXI
coinfi=COFI
linkey=LKY
maidsafecoin=MAID
zper=ZPR
cardbuyers=BCARD
flypme=FYP
savedroid=SVD
kz-cash=KZC
intervalue=INVE
ultimate-secure-cash=USC
enigma=ENG
echolink=EKO
ethbet=EBET
alpha-coin=APC
welltrado=WTL
terracoin=TRC
posw-coin=POSW
trust=TRST
themis=GET
neumark=NEU
augur=REP
aurumcoin=AU
forkcoin=FORK
suretly=SUR
horuspay=HORUS
bibox-token=BIX
suncontract=SNC
kolion=KLN
aidcoin=AID
hyper-pay=HPY
shard=SHARD
dowcoin=DOW
box-token=BOX
paxex=PAXEX
nano=NANO
gulden=NLG
shinechain=SHE
unobtanium=UNO
cwv-chain=CWV
nos=NOS
yolocash=YLC
exrnchain=EXRN
digitex-futures=DGTX
vipstar-coin=VIPS
kin=KIN
oneroot-network=RNT
skeincoin=SKC
dipnet=DPN
bitcoinfast=BCF
davinci-coin=DAC
draftcoin=DFT
thorecoin=THR
bhpcash=BHPC
mtc-mesh-network=MTC
mothership=MSP
xtrd=XTRD
daneel=DAN
pivx=PIVX
farmatrust=FTT
nebulas-token=NAS
minexcoin=MNX
bridge-protocol=TOLL
wa-space=WA
dollar-online=DOLLAR
vibe=VIBE
bitquark=BTQ
electroneum=ETN
emphy=EPY
vezt=VZT
dragon-token=DT
zrcoin=ZRC
tripio=TRIO
insureum=ISR
helper-search-token=HSN
know=KNOW
sense=SENSE
atn=ATN
avatarcoin=AV
copytrack=CPY
realchain=RCT
ruff=RUFF
bitkan=KAN
swing=SWING
acute-angle-cloud=AAC
blockcdn=BCDN
u-network=UUU
sigmacoin=SIGMA
fox-trading=FOXT
leverj=LEV
bunnytoken=BUNNY
melon=MLN
kronecoin=KRONE
investdigital=IDT
tgame=TGAME
syndicate=SYNX
blockmesh=BMH
monster-byte=MBI
akroma=AKA
rightmesh=RMESH
siacoin=SC
biocoin=BIO
cedex-coin=CEDEX
capricoin=CPC
decentralized-machine-learning=DML
songcoin=SONG
volt=ACDC
anon=ANON
tokenstars=TEAM
campuscoin=CMPCO
cashaa=CAS
bitcapitalvendor=BCV
xriba=XRA
measurable-data-token=MDT
filecoin=FIL
cannabiscoin=CANN
whalecoin=WHL
comet=CMT
etheroll=DICE
bffdoom=BFF
telcoin=TEL
siacashcoin=SCC
ubique-chain-of-things=UCT
zeusnetwork=ZEUS
espers=ESP
bitcloud=BTDX
request-network=REQ
key=KEY
bobs-repair=BOB
bitscreener-token=BITX
delphy=DPY
steepcoin=STEEP
ark=ARK
x-cash=XCASH
ucash=UCASH
model-x-coin=MODX
ordocoin=RDC
nkn=NKN
insight-chain=INB
payfair=PFR
stealth=XST
weshow-token=WET
euno=EUNO
rupee=RUP
dutch-coin=DUTCH
starbase=STAR
fortuna=FOTA
blockcat=CAT
dws=DWS
loki=LOKI
online=OIO
groestlcoin=GRS
midasprotocol=MAS
idex-membership=IDXM
ether-kingdoms-token=IMP
pirl=PIRL
smartofgiving=AOG
aurora-dao=AURA
zcore=ZCR
ergo=EFYT
xdna=XDNA
hybrid-block=HYB
arbitracoin=ATC
0x=ZRX
apx=APX
cryptonex=CNX
heronode=HER
sapien=SPN
peepcoin=PCN
nix=NIX
indahash=IDH
showhand=HAND
silent-notary=SNTR
bitcoin-planet=BTPL
waykichain=WICC
yuki=YUKI
iethereum=IETH
centaure=CEN
folmcoin=FLM
hyperstake=HYP
iota=MIOTA
bitvolt=VOLT
bean-cash=BITB
rebl=REBL
digixdao=DGD
free-coin=FREE
district0x=DNT
travelflex=TRF
veridocglobal=VDG
traceability-chain=TAC
leocoin=LEO
300-token=300
napoleonx=NPX
ethereum=ETH
cfun=CFUN
drp-utility=DRPU
bbscoin=BBS
owndata=OWN
grimcoin=GRIM
naga=NGC
coinonatx=XCXT
tronclassic=TRXC
locicoin=LOCI
wandx=WAND
ifoods-chain=IFOOD
blazecoin=BLZ
real=REAL
stakenet=XSN
read=READ
chips=CHIPS
bunnycoin=BUN
shekel=JEW
carlive-chain=IOV
c20=C20
berncash=BERN
posscoin=POSS
obxcoin=OBX
hicoin=XHI
factom=FCT
haven-protocol=XHV
primecoin=XPM
bitcoin-green=BITG
clearcoin=XCLR
lykke=LKK
darkpaycoin=DKPC
atlant=ATL
likecoin=LIKE
guaranteed-ethurance-token-extra=GETX
lightchain=LIGHT
hempcoin=THC
motocoin=MOTO
wixlar=WIX
legolas-exchange=LGO
fnkos=FNKOS
zinc=ZINC
dinero=DIN
spreadcoin=SPR
cobrabytes=COBRA
tolar=TOL
odyssey=OCN
tokugawa=TOK
ardor=ARDR
daex=DAX
faircoin=FAIR
argus=ARGUS
metamorph=METM
escrowcoin=ESCO
friends=FDZ
crowdholding=YUP
digitalnote=XDN
neblio=NEBL
incakoin=NKA
giant-coin=GIC
smartfox=FOX
nanjcoin=NANJ
signatum=SIGT
impact=IMX
consensus=SEN
xgox=XGOX
mobius=MOBI
magiccoin=MAGE
1337coin=1337
russiacoin=RC
gold-reward-token=GRX
rchain=RHOC
honey=HONEY
vsportcoin=VSC
ecocoin=ECO
mincoin=MNC
neo=NEO
asiacoin=AC
nem=XEM
plncoin=PLNC
hashcoin=HSC
bitibu-coin=BTB
pundi-x=NPXS
syncfab=MFG
zippie=ZIPT
dadi=DADI
time-new-bank=TNB
artbyte=ABY
soniq=SONIQ
howdoo=UDOO
wavesgo=WGO
zeusshield=ZSC
segwit2x=B2X
vivid-coin=VIVID
experty=EXY
jiyo-old=JIYO
bitmart-token=BMX
datarius-credit=DTRC
win-coin=WC
primalbase=PBT
acchain=ACC
knekted=KNT
sonm=SNM
bitcoin-god=GOD
rialto=XRL
biotron=BTRN
remme=REM
exmr=EXMR
iostoken=IOST
coinonat=CXT
aegeus=AEG
blockchain-certified-data-token=BCDT
gxchain=GXS
kickico=KICK
fuzzballs=FUZZ
asura-coin=ASA
unitus=UIS
havy=HAVY
dacc=DACC
sakecoin=SAKE
asiadigicoin=ADCN
bytecoin-bcn=BCN
linfinity=LFT
mithril-ore=MORE
bitcoin-private=BTCP
trueflip=TFL
loom-network=LOOM
incent=INCNT
oxycoin=OXY
cannation=CNNC
trident=TRDT
crown=CRW
creditbit=CRB
youlive-coin=UC
traxia=TMT
skycoin=SKY
harvest-masternode-coin=HC
soma=SCT
scryinfo=DDD
cardano=ADA
animation-vision-cash=AVH
trendercoin=TDC
superior-coin=SUP
ibtc=IBTC
yeed=YEED
eurocoin=EUC
molecular-future=MOF
namecoin=NMC
veritaseum=VERI
ultranote-coin=XUN
genaro-network=GNX
polybius=PLBT
digital-insurance-token=DIT
parkbyte=PKB
bitcoin-w-spectrum=BWS
ceek-vr=CEEK
mir-coin=MIR
coin2-1=C2
more-coin=MORE
supercoin=SUPER
wanchain=WAN
vaperscoin=VPRC
bismuth=BIS
dignity=DIG
smartshare=SSP
miners-reward-token=MRT
zcoin=XZC
prasm=PSM
teslacoilcoin=TESLA
savenode=SNO
six-domain-chain=SDA
inflationcoin=IFLT
bitcoin-incognito=XBI
ndex=NDX
corion=COR
pinkcoin=PINK
infinitecoin=IFC
gold-bits-coin=GBC
naviaddress=NAVI
chesscoin=CHESS
fujinto=NTO
elixir=ELIX
ezoow=EZW
bethereum=BETHER
erc20=ERC20
ratecoin=XRA
benz=BENZ
allsafe=ASAFE2
comsa-xem=CMS
morpheus-labs=MITX
helleniccoin=HNC
jsecoin=JSE
ethereumcash=ECASH
mirq=MRQ
proxeus=XES
spankchain=SPANK
terranova=TER
atlas-protocol=ATP
stronghands=SHND
messe-token=MESSE
playcoin-erc20=PLY
bitup-token=BUT
bitcoin-adult=BTAD
freicoin=FRC
litecoin-cash=LCC
pesetacoin=PTC
iungo=ING
platinumbar=XPTX
domraider=DRT
gemini-dollar=GUSD
bumo=BU
magnum=MGM
iqcash=IQ
actinium=ACM
crowdwiz=WIZ
hacken=HKN
lethean=LTHN
tajcoin=TAJ
2give=2GIVE
castle=CSTL
tokyo=TOKC
carebit=CARE
dotcoin=DOT
veltor=VLT
twinkle=TKT
brickblock=BBK
sgpay=SGP
condominium=CDM
mysterium=MYST
trinity-network-credit=TNC
bitmoney=BIT
qunqun=QUN
geertcoin=GEERT
flaxscript=FLAX
blockpass=PASS
digitalprice=DP
ethereum-meta=ETHM
moneytoken=IMT
qlink=QLC
linker-coin=LNC
carblock=CAR
mywish=WISH
capdaxtoken=XCD
agrolot=AGLT
eplus-coin=EPLUS
cabbage=CAB
mao-zedong=MAO
safe-trade-coin=XSTC
repme=RPM
cyclean=CCL
smartlands=SLT
bluzelle=BLZ
utrust=UTK
cardstack=CARD
pundi-x-nem=NPXSXEM
penta=PNT
wi-coin=WIC
bit-z-token=BZ
smoke=SMOKE
jetcoin=JET
expanse=EXP
adzcoin=ADZ
metronome=MET
halcyon=HAL
xovbank=XOV
blockchain-quotations-index-token=BQT
bitcoin-x=BTX
quasarcoin=QAC
tatatu=TTU
embers=MBRS
francs=FRN
jiyo=JIYOX
help-the-homeless-coin=HTH
stellite=XTL
eventchain=EVC
kubera-coin=KBR
bumbacoin=BUMBA
powercoin=PWR
insurepal=IPL
wink=WINK
block-chain-com=BC
gene-source-code-chain=GENE
aeternity=AE
e-dinar-coin=EDR
tourist-token=TOTO
bitcrystals=BCY
dopecoin=DOPE
pikciochain=PKC
eligma-token=ELI
hiveterminal-token=HVN
ace=ACE
mybit=MYB
gapcoin=GAP
ckusd=CKUSD
fanstime=FTI
colossusxt=COLX
metadium=META
staker=STR
centurion=CNT
storm=STORM
crevacoin=CREVA
bread=BRD
superedge=ECT
storj=STORJ
mcap=MCAP
privatix=PRIX
cappasity=CAPP
coinsuper-ecosystem-network=CEN
bridgecoin=BCO
enjin-coin=ENJ
voisecom=VOISE
suqa=SUQA
obitan-chain=OBTC
dnotes=NOTE
ac3=AC3
innova=INN
flip=FLP
flik=FLIK
manna=MANNA
fluz-fluz=FLUZ
prcoin=PRC
pumapay=PMA
food=FOOD
brat=BRAT
cloakcoin=CLOAK
fedoracoin=TIPS
bloc-money=BLOC
storjcoin-x=SJCX
acoin=ACOIN
status=SNT
bitspace=BSX
upfiring=UFR
martexcoin=MXT
waltonchain=WTC
envion=EVN
maxcoin=MAX
kyber-network=KNC
dex=DEX
master-swiscoin=MSCN
dew=DEW
desire=DSR
open-trading-network=OTN
waletoken=WTN
steneum-coin=STN
b2bx=B2B
paws-fund=PAWS
airswap=AST
callisto-network=CLO
achain=ACT
cheesecoin=CHEESE
maker=MKR
eroscoin=ERO
gossipcoin=GOSS
geocoin=GEO
cointogo=2GO
postoken=POS
twist=TWIST
nimiq=NIM
block-array=ARY
lightning-bitcoin=LBTC
liquidity-network=LQD
president-johnson=GARY
adultchain=XXX
boostcoin=BOST
litebitcoin=LBTC
kalkulus=KLKS
wxcoins=WXC
adelphoi=ADL
stratis=STRAT
hirematch=HIRE
usechain-token=USE
pixie-coin=PXC
coupecoin=COUPE
snovio=SNOV
omisego=OMG
kleros=PNK
escroco-emerald=ESCE
tether=USDT
gems-protocol=GEM
litecoin-ultra=LTCU
bitshares-music=XSD
ebtcnew=EBTC
game-stars=GST
commerceblock=CBT
dalecoin=DALC
save-and-gain=SANDG
joincoin=J
databits=DTB
bitwhite=BTW
scroll=SCRL
master-contract-token=MCT
yoyow=YOYOW
tao=XTO
ors-group=ORS
internet-of-people=IOP
fantasygold=FGC
fundtoken=FUNDZ
pepe-cash=PEPECASH
ino-coin=INO
coss=COSS
foin=FOIN
kcash=KCASH
dai=DAI
origintrail=TRAC
jury-online-token=JOT
vsync-vsx=VSX
onix=ONX
communitygeneration=CGEN
msd=MSD
tokenpay=TPAY
zenswap-network-token=ZNT
banca=BANCA
accelerator-network=ACC
golem-network-tokens=GNT
bitnautic-token=BTNT
decentralized-asset-trading-platform=DATP
influence-chain=INC
bitsend=BSD
zengold=ZENGOLD
gold-poker=GPKR
triangles=TRI
spendcoin=SPND
shopzcoin=SZC
plusonecoin=PLUS1
beat=BEAT
zest=ZEST
mojocoin=MOJO
firstblood=1ST
patientory=PTOY
starcointv=KST
sub-invest=SUBX
alibabacoin=ABBC
cryptaldash=CRD
pkg-token=PKG
shade-token=SHADE
autonio=NIO
surety=SURE
polyswarm=NCT
show=SHOW
engagement-token=ENGT
cartaxi-token=CTX
excaliburcoin=EXC
polcoin=PLC
egretia=EGT
centrality=CENNZ
kwhcoin=KWH
golos-gold=GBG
coinmeet=MEET
internet-of-things=XOT
zero=ZER
guess=GUESS
playercoin=PLACO
mallcoin=MLC
the-champcoin=TCC
eaglex=EGX
globalvillage-ecosystem=GVE
republic-protocol=REN
vericoin=VRC
pura=PURA
harmonycoin-hmc=HMC
neural-protocol=NRP
transcodium=TNS
colu-local-network=CLN
sibcoin=SIB
united-bitcoin=UBTC
open-platform=OPEN
poet=POE
chronologic=DAY
evimeria=EVI
fidentiax=FDX
dollarcoin=DLC
vites=VITES
semux=SEM
spindle=SPD
mark-space=MRK
shield-xsh=XSH
bit20=BTWTY
zip=ZIP
poa-network=POA
visionx=VNX
cofound-it=CFI
litecoin=LTC
solaris=XLR
reftoken=REF
snetwork=SNET
bitcoin-21=XBTC21
contentbox=BOX
ofcoin=OF
homeblockcoin=HBC
rpicoin=RPI
garlicoin=GRLC
ether-1=ETHO
bitsum=BSM
fintrux-network=FTX
pluton=PLU
compound-coin=COMP
eosdac=EOSDAC
vestchain=VEST
btcmoon=BTCM
zb=ZB
bonpay=BON
smartcoin=SMC
social-send=SEND
octoin-coin=OCC
fujicoin=FJC
carat=CARAT
golfcoin=GOLF
secretcoin=SCRT
zennies=ZENI
trittium=TRTT
vikkytoken=VIKKY
pascal-lite=PASL
rupaya=RUPX
library-credit=LBC
kryll=KRL
blackmoon=BMC
mithril=MITH
internxt=INXT
bitshares=BTS
iocoin=IOC
bitcore=BTX
swissborg=CHSB
force=FOR
amber=AMB
wax=WAX
bodhi-eth=BOE
axiom=AXIOM
qvolta=QVT
xrt-token=XRT
coni=CONI
pal-network=PAL
ethereum-gold=ETG
aidos-kuneen=ADK
x12-coin=X12
musiconomi=MCI
tokia=TKA
quark=QRK
tagcoin=TAG
meetone=MEETONE
gnosis-gno=GNO
bitether=BTR
zozocoin=ZZC
bitcoin-diamond=BCD
the-midas-touch-gold=TMTG
narrative=NRVE
qchi=QCH
seer=SEER
gas=GAS
libra-credit=LBA
blue-whale-token=BWX
nekonium=NUKO
crypterium=CRPT
zephyr=ZEPH
ecobit=ECOB
dacsee=DACS
dynamic=DYN
smartmesh=SMT
eximchain=EXC
dorado=DOR
fsbt-api-token=FSBT
amon=AMN
exchange-union=XUC
speedcash=SCS
nyancoin=NYAN
agrello-delta=DLT
signal-token=SIG
xmct=XMCT
croat=CROAT
chatcoin=CHAT
vertcoin=VTC
gambit=GAM
blocknode=BND
karatgold-coin=KBC
bnktothefuture=BFT
jin-coin=JIN
vitae=VITAE
bata=BTA
nubits=USNBT
nework=NKC
golos=GOLOS
eboostcoin=EBST
tokenclub=TCT
nerva=XNV
ti-value=TV
traid=TRAID
aragon=ANT
thingsoperatingsystem=TOS
bzlcoin=BZL
straks=STAK
globalboost-y=BSTY
postcoin=POST
paxos-standard-token=PAX
ronpaulcoin=RPC
global-cryptocurrency=GCC
sp8de=SPX
hubii-network=HBT
allion=ALL
interzone=ITZ
debitum-network=DEB
betacoin=BET
gcn-coin=GCN
ecoreal-estate=ECOREAL
sphre-air=XID
quantis-network=QUAN
xmax=XMX
tokes=TKS
ulord=UT
dach-coin=DACH
quant=QNT
moin=MOIN
bitzeny=ZNY
diamond=DMD
amlt=AMLT
blakecoin=BLC
1world=1WO
bancor=BNT
pigeoncoin=PGN
project-pai=PAI
zilliqa=ZIL
fantom=FTM
encryptotel=ETT
cosmo-coin=COSM
devery=EVE
rrcoin=RRC
coin=CNO
red-pulse=PHX
feathercoin=FTC
quantum-resistant-ledger=QRL
rubycoin=RBY
seal-network=SEAL
vethor-token=VTHO
noah-coin=NOAH
playkey=PKT
dynamiccoin=DMC
nushares=NSR
infinity-economics=XIN
karma-eos=KARMA
xyo-network=XYO
bitcoin-plus=XBC
quantstamp=QSP
weth=WETH
embercoin=EMB
arionum=ARO
wild-crypto=WILD
gifto=GTO
qyno=QNO
palletone=PTN
civic=CVC
aston=ATX
singularitynet=AGI
zap=ZAP
bitblocks=BBK
stk=STK
bitcny=BITCNY
cyber-movie-chain=CMCT
blackcoin=BLK
parallelcoin=DUO
phi-token=PHI
niobio-cash=NBR
theresa-may-coin=MAY
zencash=ZEN
wetoken=WT
nper=NPER
crypto-com=MCO
humanscape=HUM
azart=AZART
bitbase=BTBc
condensate=RAIN
ignition=IC
singulardtv=SNGLS
xtrabytes=XBY
gentarium=GTM
bankcoin=B@
hdac=HDAC
tidex-token=TDX
mass-vehicle-ledger=MVL
usd-coin=USDC
budbo=BUBO
smart-application-chain=SAC
penguin-coin=PENG
apot=APOT
havven=HAV
power-ledger=POWR
ebcoin=EBC
daostack=GEN
aidoc=AIDOC
adtoken=ADT
logiscoin=LGS
energo=TSL
decent-bet=DBET
birds=BIRDS
mero=MERO
energi=NRG
orbis-token=OBT
lympo=LYM
bitclave=CAT
archetypal-network=ACTP
digital-asset-guarantee-token=DAGT
alttex=ALTX
bitcoin=BTC
selfsell=SSC
dynamic-trading-rights=DTR
teloscoin=TELOS
cryptojacks=CJ
mex=MEX
photon=PHO
thore-cash=TCH
decentraland=MANA
litecred=LTCR
futurocoin=FTO
witchain=WIT
sharder=SS
nucleus-vision=NCASH
karma=KRM
aventus=AVT
bittwatt=BWT
puregold-token=PGT
dragonchain=DRGN
skyhub-coin=SHB
cybermiles=CMT
bitcoin-file=BIFI
contractnet=CNET
divi=DIVI
votecoin=VOT
salus=SLS
beekan=BKBT
helium=HLM
zcash=ZEC
cybervein=CVT
webchain=WEB
nyerium=NYEX
primestone=PSC
darcrus=DAR
first-bitcoin=BIT
verime=VME
payday-coin=PDX
trakinvest=TRAK
cropcoin=CROP
bitcoin-interest=BCI
linda=LINDA
attention-token-of-media=ATM
crystal-token=CYL
bounty0x=BNTY
ripple=XRP
gainer=GNR
pillar=PLR
vice-industry-token=VIT
endorsit=EDS
woodcoin=LOG
typerium=TYPE
etherparty=FUEL
te-food=TFD
all-sports=SOC
hycon=HYC
maecenas=ART
wings=WINGS
kanadecoin=KNDC
tomochain=TOMO
xenon=XNN
arbitragect=ARCT
local-world-forwarders=LWF
startcoin=START
lendroid-support-token=LST
acre=ACRE
futurax=FTXT
white-standard=WSD
level-up=LUC
credo=CREDO
ourcoin=OUR
vinchain=VIN
tiesdb=TIE
op-coin=OPC
guccionecoin=GCC
dprating=RATING
topchain=TOPC
bowscoin=BSC
fastcoin=FST
odem=ODE
maverick-chain=MVC
bitcoin-atom=BCA
bitcoen=BEN
iridium=IRD
airbloc=ABL
ipchain=IPC
neuro=NRO
insolar=INS
counterparty=XCP
moac=MOAC
birake=BIR
dystem=DTEM
uralscoin=URALS
endor-protocol=EDR
mustangcoin=MST
microbitcoin=MBC
bitradio=BRO
rubex-money=RBMC
eden=EDN
modum=MOD
bytom=BTM
bitcoinus=BITS
zebi=ZCO
well=WELL
oceanlab=OCL
future1coin=F1C
leadcoin=LDC
happycoin=HPC
apis=APIS
steem=STEEM
tron=TRX
scriv-network=SCRIV
populous=PPT
ultracoin=UTC
kurrent=KURT
ether-zero=ETZ
lockchain=LOC
mintcoin=MINT
boolberry=BBR
ibank=IBANK
prochain=PRA
tokenomy=TEN
cryptopay=CPAY
datawallet=DXT
blast=BLAST
vector=VEC2
maggie=MAG
esports-token=EST
effect-ai=EFX
giga=XG
ejoy=EJOY
kingxchain=KXC
catocoin=CATO
elcoin-el=EL
cream=CRM
everus=EVR
roulettetoken=RLT
crowd-machine=CMCT
korecoin=KORE
0xcert=ZXC
xaurum=XAUR
zoomba=ZBA
linkeye=LET
nexus=NXS
crea=CREA
tcoin=TCN
mirai=MRI
irishcoin=IRL
noblecoin=NOBL
cryptosolartech=CST
eternity=ENT
nebula-ai=NBAI
x8x-token=X8X
rapids=RPD
breakout-stake=BRX
gamecredits=GAME
nexty=NTY
phantomx=PNX
qubitica=QBIT
internet-node-token=INT
verify=CRED
eunomia=ENTS
bitcoal=COAL
ilcoin=ILC
ivy=IVY
cjs=CJS
spectre-dividend=SXDT
mainstream-for-the-underground=MFTU
six=SIX
ethersportz=ESZ
ethbits=ETBS
teslacoin=TES
indicoin=INDI
sharpe-platform-token=SHP
micromoney=AMM
nexium=NXC
mediccoin=MEDIC
wowbit=WWB
eternal-token=XET
greenmed=GRMD
bitnewchain=BTN
amsterdamcoin=AMS
signals-network=SGN
ragnarok=RAGNA
iotex=IOTX
apex=CPX
get-protocol=GET
aware=AT
relex=RLX
coffeecoin=CFC
ionchain=IONC
uptoken=UP
optitoken=OPTI
sociall=SCL
arbitrage=ARB
loopring-neo=LRN
veriumreserve=VRM
delizia=DELIZ
jet8=J8T
potcoin=POT
0chain=ZCN
eidoo=EDO
bionic=BNC
doc-com-token=MTC
neo-gold=NEOG
wearesatoshi=WSX
exclusivecoin=EXCL
soilcoin=SOIL
waves-community-token=WCT
salt=SALT
edrcoin=EDRC
masternet=MASH
atc-coin=ATCC
ixtus-edutainment=IXE
b2bcoin=BBC
clubcoin=CLUB
winding-tree=LIF
halalchain=HLC
concoin=CONX
magnetcoin=MAGN
unikoin-gold=UKG
crave=CRAVE
tokenbox=TBX
skincoin=SKIN
fire-lotto=FLOT
elementrem=ELE
cmitcoin=CMIT
litebar=LTB
mixin=XIN
karbo=KRB
dmarket=DMT
stellar=XLM
cryptosoul=SOUL
komodo=KMD
sophiatx=SPHTX
webcoin=WEB
sakura-bloom=SKB
arion=ARION
soarcoin=SOAR
ethereum-classic=ETC
wepower=WPR
crypto-improvement-fund=CIF
dropil=DROP
tellurion=TELL
opus=OPT
alphacat=ACAT
zclassic=ZCL
babb=BAX
universe=UNI
stasis-eurs=EURS
peerplays-ppy=PPY
luna-coin=LUNA
zen-protocol=ZP
universa=UTNP
lobstex=LOBS
stox=STX
flo=FLO
litex=LXT
funfair=FUN
coin2play=C2P
fabric-token=FT
candy=CANDY
tenx=PAY
baasid=BAAS
e-gulden=EFL
olive=OLE
dovu=DOV
investfeed=IFT
memetic=MEME
fantasy-cash=FANS
omni=OMNI
phantasma=SOUL
medx=MEDX
bankera=BNK
bodhi=BOT
boxx-token-blockparty=BOXX
sooncoin=SOON
ethos=ETHOS
presearch=PRE
moss-coin=MOC
electrifyasia=ELEC
redcoin=RED
aigang=AIX
sequence=SEQ
maximine-coin=MXM
eryllium=ERY
bee-token=BEE
breakout=BRK
nullex=NLX
blocklancer=LNC
substratum=SUB
gohelpfund=HELP
iticoin=ITI
virtacoin=VTA
mnpcoin=MNP
civitas=CIV
massgrid=MGD
santiment=SAN
breezecoin=BRZC
dav-coin=DAV
sopay=SOP
lemochain=LEMO
metaverse=ETP
waves=WAVES
neurotoken=NTK
banyan-network=BBN
obits=OBITS
local-coin-swap=LCS
blocknet=BLOCK
ion=ION
data-exchange=DTX
imbrex=REX
digital-asset-exchange-token=DAXT
ugchain=UGC
women=WOMEN
titcoin=TIT
prizm=PZM
aces=ACES
ztcoin=ZT
advanced-internet-blocks=AIB
cube=AUTO
bolivarcoin=BOLI
version=V
8bit=8BIT
travala=AVA
aced=ACED
equitrader=EQT
rusgas=RGS
tezos=XTZ
quanta-utility-token=QNTU
ink=INK
cryptoping=PING
global-social-chain=GSC
flixxo=FLIXX
citadel=CTL
gincoin=GIN
tigereum=TIG
litecoin-plus=LCP
